#
*
################################################################################
#                                                                              #
#                                                                              #
#                                                                              #
#                                                                              #
#                                                                              #
#                                                                              #
#                                                                              #
#                                                                              #
#                                                                              #
#                                                                              #
#                                                                              #
#                                                                              #
#                                                                              #
#                                                                              #
#                                                                              #
#                                                                              #
#                                                                              #
#                                                                              #
#                                                                              #
#                                                                              #
#                                                                              #
#                                                                              #
#                                                                              #
#                                                                              #
#                                                                              #
#                                                                              # 
#                                                                              #
#                                                                              #
#                            ##########  ##########                            #
#                            #                    #                            #
#                            #                    #                            #
#                            #                    #                            #
#                            #                    #                            #
#                            #                    #                            #
#                            #                    #                            #
#                            #                    #                            #
#                            #                    #                            #
#                            #                    #                            #
#                                      *                                       #
#                                                                              #
#                            #                    #                            #
#                            #                    #                            #
#                            #                    #                            #
#                            #                    #                            #
#                            #                    #                            #
#                            #                    #                            #
#                            #                    #                            #
#                            #                    #                            #
#                            #                    #                            #
#                            ##########  ##########                            #
#                                                                              #
#                                                                              #
#                                                                              #
#                                                                              #
#                                                                              #
#                                                                              #
#                                                                              #
#                                                                              #
#                                                                              #
#                                                                              #
#                                                                              #
#                                                                              #
#                                                                              #
#                                                                              #
#                                                                              #
#                                                                              #
#                                                                              #
#                                                                              #
#                                                                              #
#                                                                              #
#                                                                              #
#                                                                              #
#                                                                              #
#                                                                              #
#                                                                              #
#                                                                              #
#                                                                              #
#                                                                              #
################################################################################
