%%%%%%%%%%%%%%%%%%%%%%%%%%%%%%%%%%%%%%%%%%%%%%%%%%%%%%%%%%%%%%%%%%%%%%%%%%%%%%%%
%                                                                              %
%                                                                              %
%                                                                              %
%                                                                              %
%                                                                              %
%                                                                              %
%                                                                              %
%                                                                              %
%                                                                              %
%                                                                              %
%                                                                              %
%                                                                              %
%                                                                              %
%                                                                              %
%                                                                              %
%                                                                              %
%                                                                              %
%                                                                              %
%                                                                              %
%                                                                              %
%                                                                              %
%                                                                              %
%                                                                              %
%                                                                              %
%                                                                              %
%                                                                              % 
%                                                                              %
%                                                                              %
%                            ##########  ##########                            %
%                            #                    #                            %
%                            #                    #                            %
%                            #                    #                            %
%                            #                    #                            %
%                            #                    #                            %
%                            #                    #                            %
%                            #                    #                            %
%                            #                    #                            %
%                            #                    #                            %
%                                                                              %
%                                                                              %
%                            #                    #                            %
%                            #                    #                            %
%                            #                    #                            %
%                            #                    #                            %
%                            #                    #                            %
%                            #                    #                            %
%                            #                    #                            %
%                            #                    #                            %
%                            #                    #                            %
%                            ##########  ##########                            %
%                                                                              %
%                                                                              %
%                                                                              %
%                                                                              %
%                                                                              %
%                                                                              %
%                                                                              %
%                                                                              %
%                                                                              %
%                                                                              %
%                                                                              %
%                                                                              %
%                                                                              %
%                                                                              %
%                                                                              %
%                                                                              %
%                                                                              %
%                                                                              %
%                                                                              %
%                                                                              %
%                                                                              %
%                                                                              %
%                                                                              %
%                                                                              %
%                                                                              %
%                                                                              %
%                                                                              %
%                                                                              %
%%%%%%%%%%%%%%%%%%%%%%%%%%%%%%%%%%%%%%%%%%%%%%%%%%%%%%%%%%%%%%%%%%%%%%%%%%%%%%%%
